70 14
100 100
35 36 39 63 66 66 69 72 75 78 81 81 81 81 81 81 81 81 81 81 81 81 22 28 82 62 65 65 65 65 65 65 65 65 68 81 81 81 81 81 72 75 76 76 76 79 82 31 34 37 82 85 87 87 87 87 86 71 74 77 61 64 64 64 64 64 64 64 64 67
38 81 81 81 81 81 81 72 75 78 81 11 14 14 17 81 11 14 14 14 17 81 22 28 81 63 66 66 66 66 65 65 65 65 68 81 81 81 81 81 72 78 81 81 81 81 81 32 35 38 81 52 55 55 55 55 58 72 75 78 62 65 65 65 65 65 65 65 65 68
38 81 81 81 81 81 81 73 76 79 81 12 15 15 18 81 12 15 15 15 18 81 22 28 81 81 81 81 81 81 63 66 66 66 69 82 82 81 82 82 72 78 81 71 77 81 81 32 35 38 81 85 41 44 44 47 58 72 75 78 63 66 66 66 66 66 66 66 66 69
39 81 81 81 81 81 81 81 81 81 81 13 16 16 19 81 13 16 16 16 19 81 22 28 81 81 81 81 81 81 81 81 81 81 81 81 81 81 81 81 73 79 81 72 78 81 31 35 35 38 81 85 42 45 45 48 58 72 75 78 81 81 81 81 81 84 84 84 84 84
81 81 81 81 81 81 81 71 74 77 81 81 81 81 81 81 81 81 81 81 81 81 22 28 81 84 84 84 81 61 64 67 81 81 81 81 81 81 81 81 81 81 81 72 78 81 32 35 35 38 81 85 43 46 46 49 58 73 76 79 81 81 81 81 81 84 84 84 84 84
81 84 81 84 81 84 81 72 75 78 81 21 24 24 24 24 24 24 24 24 24 24 25 28 81 84 84 84 81 62 65 68 81 11 14 14 17 81 11 14 14 17 81 72 78 81 32 35 35 38 81 85 55 55 55 55 58 81 81 81 81 81 81 81 81 84 84 84 84 84
81 81 84 81 84 81 84 72 75 78 81 22 25 25 26 26 26 26 26 26 26 26 25 28 81 84 84 84 81 62 65 68 81 12 15 15 18 81 12 15 15 18 81 72 78 81 32 35 35 38 81 85 41 44 47 55 58 71 74 77 81 81 81 81 81 84 84 84 84 84
81 84 81 84 81 84 81 73 76 79 81 23 26 29 81 81 81 81 81 81 81 81 22 28 81 84 84 84 81 62 65 68 81 13 16 16 19 81 13 16 16 19 81 72 78 81 32 35 35 38 81 85 42 45 48 55 58 72 75 78 81 31 34 34 34 34 34 34 37 84
82 81 81 81 81 81 81 81 81 81 81 81 81 81 81 51 54 54 54 54 57 81 22 28 81 84 84 84 81 62 65 68 81 81 81 81 81 81 81 81 81 81 81 72 78 81 33 36 36 39 81 85 42 45 48 55 58 72 75 78 81 32 35 35 35 35 35 35 38 84
34 34 34 34 37 51 54 54 54 54 54 54 54 54 54 55 41 44 44 47 58 81 22 28 81 81 81 81 81 62 65 68 82 51 54 54 54 54 54 54 54 57 81 72 78 81 81 81 81 81 81 85 43 46 49 55 58 72 75 78 81 33 36 36 36 36 36 36 39 84
35 35 35 35 38 85 83 83 41 44 44 44 47 83 87 87 43 46 46 49 86 82 22 28 82 61 64 64 64 65 65 68 82 85 87 87 87 87 87 87 87 86 82 72 78 82 61 64 64 67 82 85 87 87 87 87 86 73 76 79 61 64 64 64 64 64 64 64 64 67

81 81 81 81 81 81 81 81 81 81 81 81 81 81 81 81 81 81 81 81 58 81 81 81 81 81 81 81 81 81 81 81 81 81 81 81 81 81 81 81 81 81 81 81 81 81 81 81 81 81 81 81 81 81 81 81 81 81 81 81 81 81 81 81 81 81 81 81 81 81
81 81 81 81 81 81 81 81 81 81 81 81 81 81 81 81 81 81 81 81 81 81 81 81 81 81 81 81 81 81 81 81 81 81 81 81 81 81 81 81 81 81 81 81 81 81 81 81 81 81 81 81 81 81 81 81 81 81 81 81 81 81 81 81 81 81 81 81 81 81
81 81 81 81 81 81 81 81 81 81 81 81 81 81 81 81 81 81 81 81 81 81 81 81 81 81 81 81 81 81 81 81 81 81 81 81 81 81 81 81 81 81 81 81 81 81 81 81 81 81 81 81 81 81 81 81 81 81 81 81 81 81 81 81 81 81 81 81 81 81